新御徒町
s,s,s,s,s,s,s,s,s,s
s,9,8,7,6,5,4,3,2,s
s,8,7,7,6,5,4,3,2,s
s,7,7,6,6,5,4,3,2,s
s,6,6,6,5,5,4,3,2,s
s,5,5,5,5,4,4,2,2,s
s,s,s,4,4,4,3,2,1,s
s,s,s,s,s,s,3,2,1,s
s,s,s,s,s,s,s,s,s,s
s,s,s,s,s,s,s,s,s,s


